10x10* o12
******2***
*  *     *
**     * *
*      * *
*        *
*    *   *
*        *
*   **  **
**       *
***1******
